R 1500 700
NO ./img/redbrick.xpm
SO ./img/redbrick.xpm
EA ./img/eagle.xpm
WE ./img/eagle.xpm
S ./img/barrel.xpm
F 220   0   100
C 130, 178, 255

111111111111111111111
100001000000002000001
100000000000000000001
100000000000000000011
10202020202020200W001
100000000000000000001
110000000000000000001
100000000000000000001
100000000000000000001
111111111111111111111