R 1500 700
NO ./img/redbrick.xpm
SO ./img/redbrick.xpm
EA ./img/eagle.xpm
WE ./img/eagle.xpm
S ./img/barrel.xpm
F 220   100 0
C 225   30  0

        111111111111
        11111111110111111
1111111110000001111001011
10000000001100000000N0001
1011000001110000002000001
1111111111111111111111111